0 0 0 0 0 0 0 0 0 0 0 0 0 0 0 0 0 0 0 0
0 0 0 0 0 0 0 0 0 0 0 0 0 0 0 0 0 0 0 0
0 0 0 0 0 0 0 0 0 0 0 0 0 0 0 0 0 0 0 0
0 0 1 1 1 0 0 0 0 0 0 0 0 2 6 1 1 1 0 0
0 0 1 1 1 0 2 3 2 3 2 3 2 3 0 1 1 1 0 0
0 0 1 1 1 0 3 2 3 2 3 2 3 2 0 1 1 1 0 0
0 0 1 1 1 0 2 3 2 3 2 3 2 3 0 1 1 1 0 0
0 0 1 1 1 0 3 2 3 2 3 2 3 2 0 1 1 1 0 0
0 0 1 1 1 0 2 3 2 3 2 3 2 3 0 1 1 1 0 0
0 0 1 1 1 2 3 0 0 0 0 0 0 0 0 1 1 1 0 0
0 0 0 0 0 0 0 0 0 0 0 0 0 0 0 0 0 0 0 0
0 0 0 0 0 0 0 0 0 0 0 0 0 0 0 0 0 0 0 0
0 0 0 0 0 0 0 0 0 0 0 0 0 0 0 0 0 0 0 0